p	p
ph	ph
b	b
t	t
th	th
d	d
c	c
ch	ch
k	k
kh	kh
z	z
f	f
s	s
h	h
m	m
n	n
ng	ng
l	l
r	r
w	w
j	j
pr	pr
pl	pl
phr	phr
phl	phl
tr	tr
thr	thr
kr	kr
kl	kl
kw	kw
khr	khr
khl	khl
khw	khw
br	br
bl	bl
fr	fr
fl	fl
dr	dr
i	i
e	e
x	x
v	v
q	q
a	a
u	u
o	o
@	y
ii	ii
ee	ee
xx	xx
vv	vv
qq	qq
aa	aa
uu	uu
oo	oo
@@	yy
ia	ia
va	wa
ua	ua
iia	iia
vva	vva
uua	uua
k^	k
t^	t
p^	p
ng^	ng
n^	n
m^	m
j^	j
w^	w
f^	f
l^	l
s^	s
ch^	ch
fs^	fs
jf^	jf
js^	js
ks^	ks
lch^	ltch
ls^	ls
ms^	ms
nch^	ntch
ns^	ns
ps^	ps
ts^	ts
wf^	wf
z^	-
0	-
1	-
2	-
3	-
4	-
